#
# OpenRadar menu based atcMessages
#
in=Welcome to the <aptname> area -- are you inbound <icao>? FGCOM <com0>
out=Welcome to <aptname> - please advise ATC of your intentions, FGCOM <com0>
radar=Radar Contact range <distance> mi, QNH <hPa>/<mmHg>, active rwy(s) <runways-land>, FGCOM <com0>
own=Resume your OWN navigation - Frequency change approved - Radar surveillance remains active
end=You are leaving my airspace - Frequency change approved - Radar service terminated
atis=ATIS for <icao> at <icao-altitude> ft: QNH <hPa>/<mmHg> wind <winds> active rwy(s) <runways><com_all>
rgd=Thanks for flying with us today. Have a good day

en=Engine startup approved, please indicate planned destination
pb=Pushback approved facing {0}
tx=Taxi to holding-point, runway {0.RWY}
hs=Hold short runway {0.RWY}

lw=Line up and wait on runway, report when ready for departure
mc=Maintain runway heading, climb to {0.ALT}
to=Wind <winds>, cleared for takeoff runway {0.RWY}

tl=Turn left heading {0}
tr=Turn right heading {0}
cm=Climb and maintain {0.ALT}
dm=Descend and maintain {0.ALT}

rs=Reduce speed to {0}

ils=<distance> mi out, maintain hdg until intercepting localizer, cleared for ILS appr rwy {0.RWY}
ris=<distance> mi out, report when you have runway in sight
lan=<distance> mi out, wind <winds> , cleared to land rwy {0.RWY}
vac=Welcome to <aptname> -- exit runway to the {0}
csr=Cleared to cross runway {0}

chat=Please use FGCOM <com0> only to talk to ATC, NOT to chat between airmen!
disturb=You are disturbing our ATC training --> please use another airport for uncontrolled flying
getoff=Please do not start your session on an active runway - Get OFF runway fast

sqa=Squawk <squawk-next>
sqv=Squawk VFR!
sqi=Squawk IFR!
sqm=Squawk {0.SQUAWK}

url=http://charts\.aero/airport/<icao>
trans=Please perform transition at <transitionAlt>/<transitionFL> (QNH <mmHg>/<hPa>)
